10,10,,,,,,,,
Prefabs/Map/FloorArea1,Prefabs/Map/WallArea1,,,,,,,,
0,3,,,,,,,,
1,1,1,1,1,1,1,1,1,1
1,0,0,0,1,0,1,0,0,1
1,0,1,1,1,0,1,0,0,1
1,0,1,1,0,0,1,1,0,1
1,0,0,0,1,0,0,0,0,1
1,0,1,0,0,1,0,0,1,1
1,0,1,0,1,0,1,0,0,1
1,0,1,1,1,0,1,1,0,1
1,1,0,0,0,0,0,0,0,1
1,1,1,1,1,1,1,1,1,1
