10,10,,,,,,,,
Prefabs/FloorArea1,Prefabs/WallArea1,,,,,,,,
0,3,,,,,,,,
1,1,1,1,1,1,1,1,1,1
1,1,0,0,0,0,0,0,0,1
1,0,1,0,0,0,0,0,0,1
1,0,0,1,0,0,0,0,0,1
1,0,0,0,1,0,0,0,0,1
1,0,0,0,0,1,0,0,0,1
1,0,0,0,0,0,1,0,0,1
1,0,0,0,0,0,0,1,0,1
1,0,0,0,0,0,0,0,1,1
1,1,1,1,1,1,1,1,1,1
